04,04,04,04,04,04,04,04,04,04,13,13,13,13,13,13,13,13,13,13,13,13,13,13,04
04,04,04,04,04,04,04,04,04,04,13,00,00,00,00,00,00,00,00,00,00,00,00,13,04
04,04,04,04,04,04,04,04,04,04,13,00,00,00,00,00,00,00,00,00,00,00,00,00,13
04,04,04,04,04,04,04,04,04,04,13,00,00,00,00,00,00,00,15,00,00,00,00,00,13
04,04,04,04,04,04,13,13,13,13,13,00,00,00,00,15,15,15,15,00,00,00,00,00,13
04,04,04,04,04,13,00,00,00,00,00,00,00,00,00,15,15,15,15,00,00,00,00,00,13
13,13,13,13,13,13,00,00,00,00,00,00,00,00,00,00,00,15,15,15,00,00,00,00,13
13,00,00,00,00,00,00,00,00,00,00,00,00,00,00,00,00,00,00,15,00,00,00,00,13
13,00,00,00,00,00,00,00,00,00,00,00,01,00,00,01,00,00,00,15,00,00,00,00,13
13,00,00,13,13,13,00,00,00,00,00,00,00,00,00,00,00,00,00,15,00,00,00,00,13
13,00,00,13,04,04,13,00,00,00,01,00,00,00,00,00,17,16,16,15,00,00,00,00,00
13,00,00,13,04,04,13,00,00,00,00,00,00,00,00,00,00,00,00,00,00,00,00,00,00
13,00,00,13,04,04,04,13,13,00,00,00,00,00,01,00,00,00,00,00,00,00,00,00,00
13,00,00,13,13,04,04,04,13,00,00,00,00,00,00,00,00,00,00,00,00,00,00,01,00
13,00,00,00,00,13,04,04,13,13,13,13,13,13,13,13,00,00,13,13,00,00,00,00,00
13,00,00,00,00,13,04,04,04,04,04,04,04,04,04,13,00,00,13,04,13,13,13,13,13
13,00,00,00,00,13,04,04,04,04,04,04,04,04,04,04,04,04,04,04,04,04,04,04,04
13,00,00,00,00,13,04,04,04,04,04,04,04,04,04,04,04,04,04,04,04,04,04,04,04
13,00,00,00,00,13,04,04,04,04,04,04,04,04,04,04,04,04,04,04,04,04,04,04,04
13,13,13,13,13,13,04,04,04,04,04,04,04,04,04,04,04,21,04,04,04,04,04,04,04

0,0,0,0,0,0,0,0,0,0,0,1,1,1,1,1,1,1,1,1,1,1,0,0,0
0,0,0,0,0,0,0,0,0,0,1,0,0,0,0,0,0,0,0,0,0,0,1,0,0
0,0,0,0,0,0,0,0,0,0,1,0,0,0,0,0,0,0,0,0,0,0,0,1,0
0,0,0,0,0,0,0,0,0,0,1,0,0,0,0,0,0,0,1,0,0,0,0,0,1
0,0,0,0,0,0,1,1,1,1,1,0,0,0,0,1,1,1,1,0,0,0,0,0,1
0,0,0,0,1,1,0,0,0,0,0,0,0,0,0,0,1,0,1,0,0,0,0,0,1
0,1,1,1,1,1,0,0,0,0,0,0,0,0,0,0,0,1,1,1,0,0,0,0,1
1,0,0,0,0,0,0,0,0,0,0,0,0,0,0,0,0,0,0,1,0,0,0,0,1
1,0,0,0,0,0,0,0,0,0,0,0,0,0,0,0,0,0,0,1,0,0,0,0,1
1,0,0,1,1,1,0,0,0,0,0,0,0,0,0,0,0,0,0,1,0,0,0,0,1
1,0,0,1,0,0,1,0,0,0,0,0,0,0,0,0,1,1,1,1,0,0,0,0,1
1,0,0,1,0,0,1,0,0,0,0,0,0,0,0,0,0,0,0,0,0,0,0,0,1
1,0,0,1,0,0,0,0,1,0,0,0,0,0,0,0,0,0,0,0,0,0,0,0,1
1,0,0,1,1,0,0,0,1,0,0,0,0,0,0,0,0,0,0,0,0,0,0,0,1
1,0,0,0,0,1,0,0,0,1,1,1,1,1,1,1,0,0,1,1,0,0,0,0,1
1,0,0,0,0,1,0,0,0,0,0,0,0,0,0,0,0,0,0,0,1,1,1,1,1
1,0,0,0,0,1,0,0,0,0,0,0,0,0,0,0,0,0,0,0,0,0,0,0,0
1,0,0,0,0,1,0,0,0,0,0,0,0,0,0,0,0,0,0,0,0,0,0,0,0
1,0,0,0,0,1,0,0,0,0,0,0,0,0,0,0,0,0,0,0,0,0,0,0,0
1,1,1,1,1,0,0,0,0,0,0,0,0,0,0,0,0,0,0,0,0,0,0,0,0

0,0,0,0,0,0,0,0,0,0,0,0,0,0,0,0,0,0,0,0,0,0,0,0,0
0,0,0,0,0,0,0,0,0,0,0,0,0,0,0,0,0,0,0,0,0,2,0,0,0
0,0,0,0,0,0,0,0,0,0,0,0,0,0,0,0,0,0,0,0,0,0,0,0,0
0,0,0,0,0,0,0,0,0,0,0,0,0,0,0,0,0,0,0,0,0,0,0,0,0
0,0,0,0,0,0,0,0,0,0,0,0,0,0,0,0,0,0,0,0,0,0,1,0,0
0,0,0,0,0,0,0,0,0,0,0,0,0,0,0,0,0,0,0,0,0,0,0,0,0
0,0,0,0,0,0,0,0,0,1,0,0,0,0,0,0,0,0,0,0,0,0,0,0,0
0,0,0,0,0,0,0,0,0,0,0,0,0,0,0,0,0,0,0,0,0,0,1,0,0
0,0,1,0,0,0,0,0,0,0,0,0,0,0,0,0,1,0,0,0,0,0,0,0,0
0,0,0,0,0,0,0,0,0,0,0,1,0,0,0,0,0,0,0,0,0,0,0,0,0
0,0,0,0,0,0,0,0,0,0,0,0,0,0,0,0,0,0,0,0,0,0,0,0,0
0,0,0,0,0,0,0,0,0,0,0,0,0,0,0,0,0,0,0,0,0,0,0,0,0
0,0,0,0,0,0,0,0,0,0,0,0,0,0,0,0,0,0,0,0,0,1,0,0,0
0,0,0,0,0,0,0,0,0,0,0,0,0,0,0,0,0,0,0,0,0,0,0,0,0
0,0,0,0,0,0,0,0,0,0,0,0,0,0,0,0,0,0,0,0,0,0,0,0,0
0,0,0,0,0,0,0,0,0,0,0,0,0,0,0,0,3,3,0,0,0,0,0,0,0
0,0,0,0,0,0,0,0,0,0,0,0,0,0,0,0,0,0,0,0,0,0,0,0,0
0,0,0,0,0,0,0,0,0,0,0,0,0,0,0,0,0,0,0,0,0,0,0,0,0
0,0,0,0,0,0,0,0,0,0,0,0,0,0,0,0,0,0,0,0,0,0,0,0,0
0,0,0,0,0,0,0,0,0,0,0,0,0,0,0,0,0,0,0,0,0,0,0,0,0
